1111111111111
1CT10000000C1
1000011111001
1P00110000001
111111111T001
10000000000C1
1010011001111
1T0C11E0000T1
1111111111111
