1111111111111
1CT10000000C1
1000011111001
1P00110000001
111111111T0T1
10T00000000C1
1010T110T1111
1T0C11E000CT1
1111111111111
